+++++
+   +
+ # + +++
+ # + +.+
+++ +++.+
 ++    .+
 + # +  +
 +*  ++++
 +++++